80 12
100 100
4 4 4 4 4 4 4 4 4 4 4 4 4 4 4 4 4 4 4 4 4 4 4 4 4 4 4 4 4 4 4 4 4 4 4 4 4 4 4 4 4 4 4 4 4 4 4 4 0 0 0 0 0 0 0 0 0 0 0 0 0 0 0 0 0 0 0 0 0 0 0 0 0 0 0 0 0 0 0 4
4 0 0 0 0 0 0 0 0 0 0 0 0 0 0 0 0 0 0 0 0 0 0 0 0 0 0 0 0 0 0 0 0 0 0 0 0 0 0 0 0 0 0 0 0 0 0 0 0 0 0 0 0 0 0 0 0 0 0 0 0 0 0 0 0 0 0 0 0 0 0 0 0 0 0 0 0 0 0 4
4 0 0 0 0 0 0 0 0 0 0 0 0 0 0 0 0 0 0 0 0 0 0 0 0 0 0 0 0 0 0 0 0 0 0 0 0 0 0 0 0 0 0 0 0 0 0 0 0 0 0 0 0 0 0 0 0 0 0 0 0 0 0 0 0 0 0 0 0 0 0 0 0 0 0 0 0 0 0 4
4 0 0 0 0 0 0 0 0 0 0 0 0 0 0 0 0 0 0 0 0 0 0 0 0 0 0 0 0 0 0 0 0 0 0 0 0 0 0 0 0 0 0 0 0 0 0 0 0 0 0 0 0 0 0 0 0 0 0 0 0 0 0 0 0 0 0 0 0 0 0 0 0 0 0 0 0 0 0 4
4 0 0 0 0 0 0 0 0 0 0 0 0 0 0 0 0 0 0 0 0 0 0 0 0 0 0 0 0 0 0 0 0 0 0 0 0 0 0 0 0 0 0 0 0 0 0 0 0 0 0 0 0 0 0 0 0 0 0 0 0 0 0 0 0 0 0 0 0 0 0 0 0 0 0 0 0 0 0 4
4 0 0 0 0 0 0 0 0 0 0 0 0 0 0 0 0 0 0 0 0 0 0 0 0 0 0 0 0 0 0 0 0 0 0 0 0 0 0 0 0 0 0 0 0 0 0 0 0 0 0 0 0 0 0 0 0 0 0 0 0 0 0 0 0 0 0 0 0 0 0 0 0 0 0 0 0 0 0 4
4 0 0 0 0 0 0 0 0 0 0 0 0 0 0 0 0 0 0 0 0 5 6 6 7 0 0 0 0 0 0 0 0 0 0 0 0 0 0 0 0 0 0 0 0 0 0 0 0 0 0 0 0 0 0 0 0 0 6 6 0 0 6 6 0 0 6 6 0 0 0 0 0 0 0 0 0 0 0 4
4 0 0 0 0 0 0 0 0 0 0 0 0 0 0 0 0 0 0 0 0 0 8 8 0 0 0 0 0 0 0 0 0 0 0 0 0 0 0 0 0 0 0 0 0 0 0 0 0 0 0 0 0 0 0 20 0 0 8 8 0 0 8 8 0 0 8 8 0 0 0 0 0 0 0 0 0 0 0 4
4 0 0 0 0 0 0 0 0 0 0 0 0 0 0 0 0 0 6 6 0 0 8 8 0 0 0 0 0 0 0 0 0 0 6 6 6 0 0 6 6 6 6 6 6 0 0 6 6 6 6 0 0 6 6 6 0 0 8 8 0 0 8 8 0 0 8 8 0 0 6 6 0 0 0 0 0 0 0 4
4 0 0 0 0 0 6 6 0 0 0 0 0 0 5 6 7 0 8 8 0 0 8 8 0 0 6 6 0 0 6 6 0 0 8 8 8 0 0 8 8 8 8 8 8 0 0 8 8 8 8 0 0 0 0 0 0 0 8 8 0 0 8 8 0 0 8 8 0 0 8 8 0 0 0 0 0 0 0 20
4 6 6 6 0 0 8 8 0 0 0 0 0 0 0 8 0 0 8 8 0 0 8 8 0 0 8 8 0 0 8 8 0 0 8 8 8 0 0 8 8 8 8 8 8 0 0 8 8 8 8 0 0 0 0 0 0 0 8 8 0 0 8 8 0 0 8 8 0 0 8 8 0 0 0 0 0 0 99 20
4 8 8 8 0 0 8 8 6 6 6 6 6 0 0 8 0 0 8 8 0 0 8 8 0 0 8 8 0 0 8 8 0 0 8 8 8 6 6 8 8 8 8 8 8 6 6 8 8 8 8 0 0 0 0 0 0 0 8 8 0 0 8 8 0 0 8 8 0 0 8 8 0 0 6 6 6 6 6 6